R    500     300 

WE      ./res/purplestone.xpm

SO ./res/bluebrick.xpm
NO  ./res/stone1.xpm


EA ./res/stone2.xpm

S ./res/knight.xpm

F 220,100,0
C 225,30,0

111111111111
122222222021
122221122021
122221122021
122222222021
100000000001
10000000N001
111111111111