R    500 300 

WE      ./res/purplestone.xpm

SO ./res/bluebrick.xpm
NO  ./res/stone1.xpm


EA ./res/stone2.xpm

S ./res/sprites/scream.xpm


F 110,250,0
C 225,130,0


        1111111111111111111111111
        10000000000110000000000001
        1011000001110000000000001
        1001000000000000000000001
111111111011000001110000000000001
100000000000000001110111110111111
11110111111111011100000102201
11110111111111011100101100001
11000000110101000000000100001
10000000000000000000000100001
10000000000000000000000100001
11000001110101011100000100110
11110111 1110101 1000001N0001
11111111 1111111 111111111111