R     1920     1080
NO /Users/mgupta/42/Cube3d/mgupta/res/orangebrick.xpm

SO /Users/mgupta/42/Cube3d/mgupta/res/wall1.xpm
WE      /Users/mgupta/42/Cube3d/mgupta/res/bluebrick.xpm

EA /Users/mgupta/42/Cube3d/mgupta/res/wall3.xpm

F 220,   100,0

C    100,225,    255




1111111111111111111111111
1000000000000000000000001
1000000000000000000000001
1000000000000000000000001
1000000000000000000000001
1000000000000000000000001
1000000000000000000000001
1000000000000000000000001
1000000000000000000000001
1000000000000000000000001
1111111111111111111111111