R    500 300 

WE      ./res/purplestone.xpm

SO ./res/bluebrick.xpm
NO  ./res/stone1.xpm


EA ./res/stone2.xpm

S ./res/sprites/scream.xpm
D ./res/sprites/cage5.xpm
L ./res/pillar.xpm


F 110,250,0
C 225,130,0


        1111111111111111111111111
        10000020000110000000000001
        1011000001110000000000001
        10010000000000020000003001
111111111011000001110000022000001
100000000000000001110111100011111
11110111111111011100000120001
11110111111111011100101100001
11000000110101000000000200001
10002000000000000000000100001
10000000000000000000000100001
11000001110101011100000100111
11110111 1110101 1000001N0001
11111111 1111111 111111111111